width 37
height 21
map
@@@@@@@@@@@@@@@@@@@@@@@@@@@@@@@@@@@@@
@...................................@
@...................................@
@..........@@@@@@@@@@@@@@@..........@
@...................................@
@...........@@@@@@@@@@@@............@
@...................................@
@..............@@@@@@...............@
@...................................@
@.................@.................@
@...................................@
@...............................@@@@@
@...............................@...@
@...........@@@@@@@@@@@@@@@.....@...@
@.........................@.....@...@
@.........................@.....@...@
@.........................@.....@@@@@
@.........................@.........@
@.........................@.........@
@...........@@@@@@@@@@@@@@@.........@
@@@@@@@@@@@@@@@@@@@@@@@@@@@@@@@@@@@@@